50 40
TTTTTTTTTTTTTTTTTTTTTTTTTTTTTTTTTTTTTTTTTTTTTTTTTT
TOZZZZZZZZZTTTTTTTTZZZZZZZ122223ZZZZZZZZtTTTTTTTTT
TTTTTTTTttZZZTTTTTZZZttTTTTRRRRTTTTTTttZZZZTTTTTTT
TTTTTTTTZZZZZZZZZTTtZtTTTTTRRRRTTTTTTTTttZZZTTTTTT
TTTTTTTTTTTTTTtZZZZZZTTTTTTRRRRTTTTTTTTTZZZtTTTTTT
TTTTTTTTTTTTTTTTTTTTTTTTTTTRRRRTTTTTTTZZZTTTTTTTTT
TTTTTTTTTTTTTTTTTTTTTTTTTTTRRRRTTTTTTtZZZZZTTTTTTT
TTTTTTTTTTTTTTTTTTTTTTTTTTTRRRRTTTTTTZZZZZZTTTTTTT
TTTTTTTTTTTTTTTTTTTZZZZTTTTRRRRTtZZZZZZZTTTTTTTTTT
TTTTTTTTTTTTTZZZZZZZttZZZZ122223ZZZZZZZtTTTTTTTTTT
TTTTTTTTTTTZZZTTTTTZZZZTTTTRRRRTTTttZZZttTTTTTTTTT
TTTTTZZZZZZZTTTTTTTTTTTTTTTRRRRTTTTtZZZZZZZTTTTTTT
TTTTtZTTTTTTTTttTTTTTTTTTTTRRRRTTTTTTTTTZZZtTTTTTT
TTTTZZTTTTTTTtZZZAtTTTTTTTTRRRRTTTTTTTTTTTZZHTTTTT
TTTTZTTTTTTTTtstTTTTTTTTTTTRRRRTTTTTTTTTTTTTTTTTTT
TTTTZTTTTTTTTTZTTTTTTTTTTTTRRRRTTTTTTTTTTTTTTTTTTT
TTTTZTTTTTTTTTZTTTTTTTTTTTTRRRRTTTTTTTTTTTTTTTTTTT
TTTTZTTTTTTZZZZZZTTTTTTTTTTRRRRTTTTTTTTTTTTTTTTTTT
TTTTZZZZZZZZTTTTZZTTTTTTTTTRRRRTTTfTTTZZHTTTTTTTTT
TTTTTTTTTTTTTTTTTZTTTTTTTTTRRRRTTZSZTZZZTTTTTTTTTT
TTTTTTTTTTTZZZZZZZZZZZZTTTTRRRRTTZZZZZTTTTTTTTTTTT
TTTTTTTTTTTZZZZZZZZZZZZTTTTRRRRTTtZtTTTTTTTTTTTTTT
TTTTTTTTTZZZZZZZZZTTTTTTTTTRRRRTTT5TTTTTTTTTTTTTTT
TTTTTTTTTZZZZZTTTTTTTTTTTTTRRRRTTT55TTTTTTTTTTTTTT
TTTTTTTZZZZZTTTTTTTTTTTTTTTRRRRTTTT5TTTTTTTTTTTTTT
TTTTTTTZZtTTTTTTTTTTTTTTTTTRRRRTTTT55TTTTTTTTTTTTT
TTTTTTTZZtTZZZZZZZZZZZZtTTTRRRRTTTTT55TTTTTTTTTTTT
TTTTTTTTZZZZZZZZZZZZZZZZtTTRRRRTTTTTT555555TTTTTTT
TTTTTTTTTZZZZZZZZZZZZZZZZZTRRRRTTTTTTTTTTT555TTTTT
TTTTTTTTTTTZZZZZZZZZZZZZZZTRRRRTTTTTTTTTTTTT55TTTT
TTTTAZZZTTTZZZZZZZZZZZZZZs122223ZZZZZZZZZZZZZZZTTT
TTTTTZZZTTTZZZZZZZZZZZZZZZTRRRRTZZZZZZZZZZZZZZZTTT
TTTTTTtZZZtZZZZZZZZZZZZZZZTRRRRTZZZZZZZZZZZZZZZTTT
TTTTTTTTtZZZZZZZZZZZZZZZZZtRRRRtZZZZZZZZZZZZZZZTTT
TTTTTTtZZZtZZZZZZZZZZZZZZZZRRRRZZZZZZZZZZZZZZZZTTT
TTTTTZZZTTTZZZZZZZZZZZZZZZZRRRRZZZZZZZZZZZZZZZZTTT
TTTTTZZZTTTZZZZZZZZZZZZZZZtRRRRtZZZZZZZZZZZZZZZTTT
TTTTTTTTTTTTTTTTTTTTTTTttTTRRRRTZZZZZZZZZZZpZZZTTT
TTTTTTTTTTTTTTTTTTTTTTTTTTTRRRRTZZZZZZZZZZZZZZZTTT
TTTTTTTTTTTTTTTTTTTTTTTTTTTRRRRTTTTTTTTTTTTTTTTTTT
