50 40
TTTTTTTTTTTTTTTTTTTTTTTTTTTTTTTTTTTTTTTTTTTTTTTTTT
TOZZZZZZZZZTTTTTTTTZZbZZZZ122223ZZZbZZZZtTTTTTTTTT
TTTTTTTTttZZZTTTTTZZZttTTTTRRRRTTTTTTttZZZZTTTTTTT
TTTTTTTTZZZZZZZZZTTtZtTTTTTRRRRTTTTTTTTttZZZTTTTTT
TTTTTTTTTTTTTTtZZZZZZTTTTTTRRRRTTTTTTTTTZZZtTTTTTT
TTTTTTTTTTTTTTTTTTTTTTTTTTTRRRRTTTTTTTZZZTTTTTTTTT
TTTTTTTTTTTTTTTTTTTTTTTTTTTRRRRTTTTTTtZZZZZTTTTTTT
TTTTTTTTTTTTTTTTTTTTTTTTTTTRRRRTTTTTTZZZZZZTTTTTTT
TTTTTTTTTTTTTTTTTTTZbZZTTTTRRRRTtZZZZZZZTTTTTTTTTT
TTTTTTTTTTTTTZZZZZZZttZZZZ122223ZZZZZZZtTTTTTTTTTT
TTTTTTTTTTTZZZTTTTTZZZZTTTTRRRRTTTttZZZttTTTTTTTTT
TTTTTZZZZZZZTTTTTTTTTTTTTTTRRRRTTTTtZZZZZZZTTTTTTT
TTTTtZTTTTTTTTttTTTTTTTTTTTRRRRTTTTTTTTTZZZtTTTTTT
TTTTZZTTTTTTTtZZZHtTTTTTTTTRRRRTTTTTTTTTTTZZHTTTTT
TTTTZTTTTTTTTtstTTTTTTTTTTTRRRRTTTTTTTTTTTTTTTTTTT
TTTTZTTTTTTTTTZTTTTTTTTTTTTRRRRTTTTTTTTTTTTTTTTTTT
TTTTZTTTTTTTTTZTTTTTTTTTTTTRRRRTTTTTTTTTTTTTTTTTTT
TTTTZTTTTTTZZZZZZTTTTTTTTTTRRRRTTTTTTTTTTTTTTTTTTT
TTTTZZZZZZZZTTTTZZTTTTTTTTTRRRRTTTfTTTZZHTTTTTTTTT
TTTTTTTTTTTTTTTTTZTTTTTTTTTRRRRTTZSZbZZZTTTTTTTTTT
TTTTTTTTTTTZZZZZZZZZZZZTTTTRRRRTTZZZZZTTTTTTTTTTTT
TTTTTTTTTTTZZZZZZZZZZZZTTTTRRRRTTtZtTTTTTTTTTTTTTT
TTTTTTTTTZZZZZZZZZTTTTTTTTTRRRRTTT5TTTTTTTTTTTTTTT
TTTTTTTTTZZZZZTTTTTTTTTTTTTRRRRTTT55TTTTTTTTTTTTTT
TTTTTTTZZZZZTTTTTTTTTTTTTTTRRRRTTTT5TTTTTTTTTTTTTT
TTTTTTTZZtTTTTTTTTTTTTTTTTTRRRRTTTT55TTTTTTTTTTTTT
TTTTTTTZZtTZZZZZZZZZZZZtTTTRRRRTTTTT55TTTTTTTTTTTT
TTTTTTTTZZZZZZZZZZZZZZZZtTTRRRRTTTTTT555555TTTTTTT
TTTTTTTTTZZZZZZZZZZZZZZZZZTRRRRTTTTTTTTTTT555TTTTT
TTTTTTTTTTTZZZbZZZZZZZZZZZTRRRRTTTTTTTTTTTTT55TTTT
TTTTHZZZTTTZZZZZZZZZZZZZZs122223bZZZZZZZZZZZZZZTTT
TTTTTZZZTTTZZZZZZZZZZZZZZZTRRRRTZZZZZZZZZZZZZZZTTT
TTTTTTtZZZtZZZZZZZZZZZZZZZTRRRRTZZZZZZZZZZZZZZZTTT
TTTTTTTTtZZZZZbZZZZZZZZZZZtRRRRtZZZZZZZZZZZZZZZTTT
TTTTTTtZZZtZZZZZZZZZZZZZZZZRRRRZZZZZZZZZZZZZZZZTTT
TTTTTZZZTTTZZZZZZZZZZZZZZZZRRRRZZZZZZZZZZZZZZZZTTT
TTTTTZZZTTTZZZZbZZZZZZZZZZtRRRRtZZZZZZZZZZZZZZZTTT
TTTTTTTTTTTTTTTTTTTTTTTttTTRRRRTZZZZZZZZZZZpZZZTTT
TTTTTTTTTTTTTTTTTTTTTTTTTTTRRRRTZZZZZZZZZZZZZZZTTT
TTTTTTTTTTTTTTTTTTTTTTTTTTTRRRRTTTTTTTTTTTTTTTTTTT
